Place,Competition,Country,Start Date,End Date,Part. Score,P.S. Place,Result Score,R.S. Place,Comp. Score
1,"Clyde Littlefield Texas Relays presented by Truist, Mike A. Myers Stadium, Austin, TX",USA,27 MAR 2024,30 MAR 2024,1305,3.0,83819,1,85124
2,"Pepsi Florida Relays, Percy Beard Track, Gainesville, FL",USA,29 MAR 2024,30 MAR 2024,795,4.0,83536,2,84331
3,"Battle on the Bayou, LSU Bernie Moore Stadium, Baton Rouge, LA",USA,29 MAR 2024,30 MAR 2024,465,13.0,82292,3,82757
4,"Miramar Invitational, Ansin Sports Complex, Miramar, FL",USA,06 APR 2024,06 APR 2024,1695,1.0,81011,4,82706
5,"Maurie Plant Meet, Lakeside Stadium, Melbourne",AUS,15 FEB 2024,15 FEB 2024,1460,2.0,79614,7,81074
6,"Sydney Track Classic, ES Marks Athletics Field, Sydney",AUS,23 MAR 2024,23 MAR 2024,570,10.0,79897,5,80467
7,"Adelaide Invitational, SA Athletic Stadium, Adelaide",AUS,10 FEB 2024,10 FEB 2024,730,5.0,79659,6,80389
8,"ASA Athletics Grand Prix 3 / Continental Tour Challenger, UJ Stadium, Johannesburg",RSA,27 MAR 2024,27 MAR 2024,505,12.0,79175,10,79680
9,"Stanford Invitational, Cobb Track and Angell Field, Palo Alto, CA",USA,29 MAR 2024,30 MAR 2024,240,24.0,79295,9,79535
10,"Trials for African Games 2024, Nyayo National Stadium, Nairobi",KEN,05 MAR 2024,06 MAR 2024,715,7.0,78802,12,79517
11,"Raleigh Relays, Paul Derr TF Facility, Raleigh, NC",USA,28 MAR 2024,30 MAR 2024,85,61.0,79400,8,79485
12,"Canberra Track Classic, AIS Athletics Track, Canberra",AUS,01 MAR 2024,02 MAR 2024,345,18.0,78829,11,79174
13,"Hurricane Alumni Invitational, UMiami Cobb Stadium, Coral Gables, FL",USA,05 APR 2024,06 APR 2024,630,8.0,78371,16,79001
14,"Hurricane Invitational, UMiami Cobb Stadium, Coral Gables, FL",USA,15 MAR 2024,16 MAR 2024,420,14.0,78509,14,78929
15,"USF Alumni Invitational, University of South Florida Track & Field Stadium, Tampa, FL",USA,15 MAR 2024,16 MAR 2024,35,95.0,78708,13,78743
16,"44 Farms Team Invitational, Cushing Stadium, College Station, TX",USA,05 APR 2024,06 APR 2024,225,25.0,78479,15,78704
17,"Bobcat Invitational, Bobcat Track and Field Complex, San Marcos, TX",USA,28 MAR 2024,30 MAR 2024,105,51.0,78034,18,78139
18,"Crimson Tide Invitational, Sam Bailey Track Stadium, Tuscaloosa, AL",USA,05 APR 2024,06 APR 2024,65,72.0,78054,17,78119
19,"ASA Athletics Grand Prix 2, Bestmed Tuks Stadium, Pretoria",RSA,18 MAR 2024,18 MAR 2024,195,29.0,77884,19,78079
20,"Troféu Adhemar Ferreira da Silva Loterias Caixa de Atletismo, CNDA, Bragança Paulista",BRA,05 APR 2024,07 APR 2024,410,16.0,77626,22,78036
21,"ASA Athletics Grand Prix 1, McArthur Stadium, Potchefstroom",RSA,14 MAR 2024,14 MAR 2024,420,14.0,77488,26,77908
22,"Arizona Spring Break Fiesta, Univ. of Arizona Roy P. Drachman Stadium, Tucson, AZ",USA,16 MAR 2024,16 MAR 2024,140,36.0,77637,21,77777
23,"South Florida Invitational, University of South Florida Track & Field Stadium, Tampa, FL",USA,05 APR 2024,06 APR 2024,185,31.0,77518,25,77703
24,"UCF Black & Gold Invite, UCF Soccer and Track Complex, Orlando, FL",USA,15 MAR 2024,16 MAR 2024,30,98.0,77643,20,77673
25,"Willie Williams Classic, Univ. of Arizona Roy P. Drachman Stadium, Tucson, AZ",USA,22 MAR 2024,23 MAR 2024,80,64.0,77570,23,77650
26,"Clyde Hart Classic, Clyde Hart Track & Field Stadium, Waco, TX",USA,22 MAR 2024,23 MAR 2024,95,57.0,77537,24,77632
27,"International Track Meet, Nga Puna Wai Sports Hub, Christchurch",NZL,24 FEB 2024,24 FEB 2024,730,5.0,76829,31,77559
28,"3rd AK Track And Field Weekend Meeting, Nyayo National Stadium, Nairobi",KEN,26 JAN 2024,27 JAN 2024,310,19.0,77245,27,77555
29,"Sir Graeme Douglas Memorial Track Classic, Douglas Track & Field, Auckland",NZL,10 MAR 2024,10 MAR 2024,560,11.0,76891,30,77451
30,"Keyth Talley Invitational, LSU Bernie Moore Stadium, Baton Rouge, LA",USA,23 MAR 2024,23 MAR 2024,130,42.0,77209,28,77339
31,"Jim Click Shootout & Multis, Univ. of Arizona Roy P. Drachman Stadium, Tucson, AZ",USA,05 APR 2024,06 APR 2024,130,42.0,77071,29,77201
32,"Hurricane Collegiate Invitational, UMiami Cobb Stadium, Coral Gables, FL",USA,23 MAR 2024,23 MAR 2024,265,23.0,76764,33,77029
33,"UCF Knights Invite, UCF Soccer and Track Complex, Orlando, FL",USA,22 MAR 2024,23 MAR 2024,60,75.0,76815,32,76875
34,"UC San Diego Triton Invitational, Triton Stadium, San Diego, CA",USA,05 APR 2024,06 APR 2024,410,16.0,76077,35,76487
35,"2nd AK Track & Field Weekend Meeting/AK Relay Series, Ulinzi Sports Complex, Langata, Nairobi",KEN,05 JAN 2024,06 JAN 2024,105,51.0,76347,34,76452
36,"Aztec Invitational, San Diego State University, San Diego, CA",USA,21 MAR 2024,23 MAR 2024,270,22.0,75472,37,75742
37,"AGN League 3, Pilditch Stadium, Pretoria",RSA,10 FEB 2024,10 FEB 2024,140,36.0,75547,36,75687
38,"Texas A&M Invitational, Cushing Stadium, College Station, TX",USA,23 MAR 2024,23 MAR 2024,80,64.0,75443,38,75523
39,"18th Spring Break Classic, Pista Basilio Rodriguez, Carolina",PUR,14 MAR 2024,16 MAR 2024,195,29.0,75318,39,75513
40,"FSU Relays, Florida State University - Mike Long Track, Tallahassee, FL",USA,21 MAR 2024,22 MAR 2024,85,61.0,75184,41,75269
41,"JAAA CARIFTA Trials, National Stadium, Kingston",JAM,01 MAR 2024,03 MAR 2024,0,,75256,40,75256
42,"Arkansas Spring Invitational, John McDonnell Field, Fayetteville, AR",USA,06 APR 2024,06 APR 2024,120,48.0,75065,43,75185
43,"AGN League 4, Pilditch Stadium, Pretoria",RSA,24 FEB 2024,24 FEB 2024,105,51.0,75064,44,75169
44,"Curro Podium Final, Pilditch Stadium, Pretoria",RSA,17 FEB 2024,17 FEB 2024,165,33.0,74939,46,75104
45,"VertKlasse Meeting, Dick Vert Stadium, High Point, NC",USA,05 APR 2024,06 APR 2024,160,34.0,74928,47,75088
46,"Virginia Showcase, Virginia Beach Sports Center, Virginia Beach, VA",USA,12 JAN 2024,14 JAN 2024,10,127.0,75076,42,75086
47,"Kirk Baptiste Spring Break Invitational, Tom Tellez Track, Houston, TX",USA,14 MAR 2024,14 MAR 2024,75,69.0,75003,45,75078
48,"Masked Rider Open, Terry & Linda Fuller T&F Complex, Lubbock, TX",USA,22 MAR 2024,23 MAR 2024,45,88.0,74891,48,74936
49,"Africa Games National Trials, Stephen Keshi Stadium, Asaba",NGR,17 FEB 2024,19 FEB 2024,0,,74840,49,74840
50,"WT Jo Meaker Classic & Multi, West Texas A&M University Track & Soccer Complex, Canyon, TX",USA,04 APR 2024,05 APR 2024,0,,74775,50,74775
51,"Tennessee Invite, Tom Black Track at LaPorte Stadium, Knoxville, TN",USA,05 APR 2024,06 APR 2024,30,98.0,74692,51,74722
52,"GC Foster Classic, GC Foster College, Spanish Town",JAM,09 MAR 2024,09 MAR 2024,295,21.0,74301,53,74596
53,"The 57th Tokyo Big 6, Keio Univ. Hiyoshi Athletics Field, Yokohama",JPN,06 APR 2024,07 APR 2024,50,80.0,74357,52,74407
54,"Joe Walker Invitational, Ole Miss T&F Complex, Oxford, MS",USA,05 APR 2024,06 APR 2024,125,47.0,74187,54,74312
55,"Bob Davidson Team Challenge presented by Norris Woody, Dick Vert Stadium, High Point, NC",USA,22 MAR 2024,23 MAR 2024,25,104.0,74133,55,74158
56,"Trojan Invite, USC Cromwell Field at Loker Track Stadium, Los Angeles, CA",USA,22 MAR 2024,23 MAR 2024,90,58.0,74054,56,74144
57,"2º Circuito Paulista OPEN, Centro de Atletismo Professor Oswaldo Terra, Sao Bernardo do Campo",BRA,16 MAR 2024,16 MAR 2024,130,42.0,73151,57,73281
58,"Ole Miss Classic, Ole Miss T&F Complex, Oxford, MS",USA,22 MAR 2024,23 MAR 2024,135,41.0,73140,58,73275
59,"AGN League 5, Pilditch Stadium, Pretoria",RSA,02 MAR 2024,02 MAR 2024,50,80.0,73090,59,73140
60,"UTSA Invitational, Park West Ath. Complex, San Antonio, TX",USA,15 MAR 2024,16 MAR 2024,20,109.0,72695,60,72715
61,"Western Milo Relays, GC Foster College, Spanish Town",JAM,10 FEB 2024,10 FEB 2024,55,78.0,72574,61,72629
62,"Sri Lanka Athletics Open Stage 1, Mahinda Rajapaksha Stadium, Diyagama",SRI,01 MAR 2024,02 MAR 2024,50,80.0,72499,62,72549
63,"AGN League 2, Pilditch Stadium, Pretoria",RSA,27 JAN 2024,27 JAN 2024,85,61.0,72452,63,72537
64,"Continental Tour Ciudad de Santiago, E.Nacional, Santiago de Chile",CHI,31 MAR 2024,31 MAR 2024,305,20.0,72159,69,72464
65,"Sam Howell Invitational, Weaver Stadium, Princeton, NJ",USA,30 MAR 2024,30 MAR 2024,10,127.0,72420,64,72430
66,"2024 Spring Challenge Meet, National Stadium, Tokyo",JPN,15 MAR 2024,17 MAR 2024,15,112.0,72365,65,72380
67,"Yellow Jacket Invitational, Geroge C. Griffin Track, Atlanta, GA",USA,16 MAR 2024,16 MAR 2024,10,127.0,72340,66,72350
68,"17th Iwakabe Cup, Athletic Park, Ageo",JPN,07 APR 2024,07 APR 2024,45,88.0,72284,67,72329
69,"Encuentro FMAA César Moreno Bravo 2024, Centro Deportivo Olímpico Mexicano, Ciudad de México",MEX,05 APR 2024,07 APR 2024,10,127.0,72271,68,72281
70,"Copa Nuevo León Luciano Ramírez Gallardo, Pista del Centro Deportivo Borregos, Estadio Azul ITESM, Monterrey",MEX,24 FEB 2024,25 FEB 2024,90,58.0,72069,70,72159
71,"Beach Opener, Jack Rose Track, Long Beach, CA",USA,01 MAR 2024,02 MAR 2024,55,78.0,71854,72,71909
72,"41th Tokai University-Nihon University Game, Nihon University Athletics Stadium, Setagaya",JPN,07 APR 2024,07 APR 2024,0,,71891,71,71891
73,"Central Hurdles Relays & Field Events, GC Foster College, Spanish Town",JAM,20 JAN 2024,20 JAN 2024,60,75.0,71796,74,71856
74,"Corporate Area Development Meet, National Stadium, Kingston",JAM,16 FEB 2024,17 FEB 2024,0,,71812,73,71812
75,"Mangrum Invitational, Mangrum Track & Field, San Marcos, CA",USA,22 MAR 2024,22 MAR 2024,0,,71706,75,71706
76,"UNLV Rebels Elite, Myron Partridge Stadium & Sheila Tarr-Smith Field, Las Vegas, NV",USA,05 APR 2024,06 APR 2024,100,54.0,71469,77,71569
77,"Oliver Nikoloff Invitational, Gettler Stadium, Cincinnati, OH",USA,29 MAR 2024,30 MAR 2024,50,80.0,71484,76,71534
78,"Grand Prix Atletica Chilena, E.Nacional, Santiago de Chile",CHI,28 MAR 2024,28 MAR 2024,225,25.0,71230,80,71455
79,"Oregon Preview, Hayward Field, Eugene, OR",USA,22 MAR 2024,23 MAR 2024,10,127.0,71425,78,71435
80,"Charles Austin Classic, Bobcat Track and Field Complex, San Marcos, TX",USA,22 MAR 2024,23 MAR 2024,45,88.0,71308,79,71353
81,"USD Early Bird, Mildred J. Hillenbrand Memorial Track, Vermillion, SD",USA,05 APR 2024,06 APR 2024,35,95.0,71190,81,71225
82,"Pre-Africa Games Meet, MKO Abiola National Stadium, Abuja",NGR,02 FEB 2024,03 FEB 2024,0,,71190,81,71190
83,"Velocity Fest 14, National Stadium, Kingston",JAM,16 MAR 2024,16 MAR 2024,620,9.0,70534,91,71154
84,"Alan Connie Shamrock Invitational, Doug Shaw Memorial Stadium, Myrtle Beach, SC",USA,14 MAR 2024,16 MAR 2024,0,,71105,83,71105
85,"22nd National Federation Cup U20, SAI Regional Centre Sarojini Nagar, Lucknow",IND,08 MAR 2024,10 MAR 2024,0,,71033,84,71033
86,"Potts Classic, Hawke's Bay Sports Park, Hastings",NZL,20 JAN 2024,20 JAN 2024,160,34.0,70821,86,70981
87,"3º Encontros de Atletismo, COTP Stadium, São Paulo",BRA,02 MAR 2024,02 MAR 2024,50,80.0,70922,85,70972
88,"AGN League 1, Pilditch Stadium, Pretoria",RSA,20 JAN 2024,20 JAN 2024,45,88.0,70782,87,70827
89,"The Vince O’Boyle Track and Field Classic, Anteater Stadium, Irvine, CA",USA,29 MAR 2024,29 MAR 2024,0,,70733,88,70733
90,"Colorado Invitational, Potts Field, Boulder, CO",USA,05 APR 2024,05 APR 2024,40,92.0,70669,89,70709
91,"Invitational Track and Field Event, National Stadium, Gaborone",BOT,17 FEB 2024,17 FEB 2024,65,72.0,70569,90,70634
92,"Camperdown Classics, National Stadium, Kingston",JAM,10 FEB 2024,10 FEB 2024,140,36.0,70393,92,70533
93,"Pomona-Pitzer Track & Field Invitational, Strehle Track, Pomona College, Claremont, CA",USA,06 APR 2024,06 APR 2024,40,92.0,70352,93,70392
94,"Queen's/Grace Jackson Track Meet, National Stadium, Kingston",JAM,27 JAN 2024,27 JAN 2024,210,27.0,70180,96,70390
95,"Cathy Freeman Shield, Queensland Sport and Athletics Centre, Nathan, Brisbane",AUS,24 FEB 2024,24 FEB 2024,35,95.0,70345,94,70380
96,"Second Qualifier - LAI, Pista Luis F. Sambolin, San Germán",PUR,22 MAR 2024,23 MAR 2024,20,109.0,70306,95,70326
97,"Youngster Goldsmith National Athletic Classic, National Stadium, Kingston",JAM,03 FEB 2024,03 FEB 2024,15,112.0,69822,97,69837
98,"Challenguer Hugo La Nasa, Cef N°3 Hugo Mario La Nasa, Concepción del Uruguay",ARG,07 APR 2024,07 APR 2024,115,49.0,69705,99,69820
99,"Dynamic Athletics Outdoor Meet, Navy New Sport Center, Lagos",NGR,27 JAN 2024,27 JAN 2024,0,,69796,98,69796
100,"Ebanks Invitational, George Mason Stadium, Fairfax, VA",USA,05 APR 2024,06 APR 2024,0,,69700,100,69700
