Place,Competition,Country,Start Date,End Date,Part. Score,P.S. Place,Result Score,R.S. Place,Comp. Score
1,"Clyde Littlefield Texas Relays presented by Truist, Mike A. Myers Stadium, Austin, TX",USA,27 MAR 2024,30 MAR 2024,1305,3.0,83819,1,85124
2,"Pepsi Florida Relays, Percy Beard Track, Gainesville, FL",USA,29 MAR 2024,30 MAR 2024,795,4.0,83536,2,84331
3,"Battle on the Bayou, LSU Bernie Moore Stadium, Baton Rouge, LA",USA,29 MAR 2024,30 MAR 2024,465,12.0,82292,3,82757
4,"Miramar Invitational, Ansin Sports Complex, Miramar, FL",USA,06 APR 2024,06 APR 2024,1695,1.0,81011,4,82706
5,"Maurie Plant Meet, Lakeside Stadium, Melbourne",AUS,15 FEB 2024,15 FEB 2024,1460,2.0,79614,7,81074
6,"Sydney Track Classic, ES Marks Athletics Field, Sydney",AUS,23 MAR 2024,23 MAR 2024,570,9.0,79897,5,80467
7,"Adelaide Invitational, SA Athletic Stadium, Adelaide",AUS,10 FEB 2024,10 FEB 2024,730,5.0,79659,6,80389
8,"ASA Athletics Grand Prix 3 / Continental Tour Challenger, UJ Stadium, Johannesburg",RSA,27 MAR 2024,27 MAR 2024,505,11.0,79175,10,79680
9,"Stanford Invitational, Cobb Track and Angell Field, Palo Alto, CA",USA,29 MAR 2024,30 MAR 2024,240,21.0,79295,9,79535
10,"Trials for African Games 2024, Nyayo National Stadium, Nairobi",KEN,05 MAR 2024,06 MAR 2024,715,7.0,78802,12,79517
11,"Raleigh Relays, Paul Derr TF Facility, Raleigh, NC",USA,28 MAR 2024,30 MAR 2024,85,50.0,79400,8,79485
12,"Canberra Track Classic, AIS Athletics Track, Canberra",AUS,01 MAR 2024,02 MAR 2024,345,15.0,78829,11,79174
13,"Hurricane Invitational, UMiami Cobb Stadium, Coral Gables, FL",USA,15 MAR 2024,16 MAR 2024,420,13.0,78509,14,78929
14,"USF Alumni Invitational, University of South Florida Track & Field Stadium, Tampa, FL",USA,15 MAR 2024,16 MAR 2024,35,82.0,78708,13,78743
15,"Bobcat Invitational, Bobcat Track and Field Complex, San Marcos, TX",USA,28 MAR 2024,30 MAR 2024,105,43.0,78034,16,78139
16,"Crimson Tide Invitational, Sam Bailey Track Stadium, Tuscaloosa, AL",USA,05 APR 2024,06 APR 2024,65,61.0,78054,15,78119
17,"ASA Athletics Grand Prix 2, Bestmed Tuks Stadium, Pretoria",RSA,18 MAR 2024,18 MAR 2024,195,25.0,77884,17,78079
18,"ASA Athletics Grand Prix 1, McArthur Stadium, Potchefstroom",RSA,14 MAR 2024,14 MAR 2024,420,13.0,77488,22,77908
19,"Arizona Spring Break Fiesta, Univ. of Arizona Roy P. Drachman Stadium, Tucson, AZ",USA,16 MAR 2024,16 MAR 2024,140,30.0,77637,19,77777
20,"UCF Black & Gold Invite, UCF Soccer and Track Complex, Orlando, FL",USA,15 MAR 2024,16 MAR 2024,30,84.0,77643,18,77673
21,"Willie Williams Classic, Univ. of Arizona Roy P. Drachman Stadium, Tucson, AZ",USA,22 MAR 2024,23 MAR 2024,80,53.0,77570,20,77650
22,"Clyde Hart Classic, Clyde Hart Track & Field Stadium, Waco, TX",USA,22 MAR 2024,23 MAR 2024,95,47.0,77537,21,77632
23,"International Track Meet, Nga Puna Wai Sports Hub, Christchurch",NZL,24 FEB 2024,24 FEB 2024,730,5.0,76829,26,77559
24,"3rd AK Track And Field Weekend Meeting, Nyayo National Stadium, Nairobi",KEN,26 JAN 2024,27 JAN 2024,310,16.0,77245,23,77555
25,"Sir Graeme Douglas Memorial Track Classic, Douglas Track & Field, Auckland",NZL,10 MAR 2024,10 MAR 2024,560,10.0,76891,25,77451
26,"Keyth Talley Invitational, LSU Bernie Moore Stadium, Baton Rouge, LA",USA,23 MAR 2024,23 MAR 2024,130,36.0,77209,24,77339
27,"Hurricane Collegiate Invitational, UMiami Cobb Stadium, Coral Gables, FL",USA,23 MAR 2024,23 MAR 2024,265,20.0,76764,28,77029
28,"UCF Knights Invite, UCF Soccer and Track Complex, Orlando, FL",USA,22 MAR 2024,23 MAR 2024,60,64.0,76815,27,76875
29,"2nd AK Track & Field Weekend Meeting/AK Relay Series, Ulinzi Sports Complex, Langata, Nairobi",KEN,05 JAN 2024,06 JAN 2024,105,43.0,76347,29,76452
30,"Aztec Invitational, San Diego State University, San Diego, CA",USA,21 MAR 2024,23 MAR 2024,270,19.0,75472,31,75742
31,"AGN League 3, Pilditch Stadium, Pretoria",RSA,10 FEB 2024,10 FEB 2024,140,30.0,75547,30,75687
32,"Texas A&M Invitational, Cushing Stadium, College Station, TX",USA,23 MAR 2024,23 MAR 2024,80,53.0,75443,32,75523
33,"18th Spring Break Classic, Pista Basilio Rodriguez, Carolina",PUR,14 MAR 2024,16 MAR 2024,195,25.0,75318,33,75513
34,"FSU Relays, Florida State University - Mike Long Track, Tallahassee, FL",USA,21 MAR 2024,22 MAR 2024,85,50.0,75184,35,75269
35,"JAAA CARIFTA Trials, National Stadium, Kingston",JAM,01 MAR 2024,03 MAR 2024,0,,75256,34,75256
36,"Arkansas Spring Invitational, John McDonnell Field, Fayetteville, AR",USA,06 APR 2024,06 APR 2024,120,41.0,75065,37,75185
37,"AGN League 4, Pilditch Stadium, Pretoria",RSA,24 FEB 2024,24 FEB 2024,105,43.0,75064,38,75169
38,"Curro Podium Final, Pilditch Stadium, Pretoria",RSA,17 FEB 2024,17 FEB 2024,165,28.0,74939,40,75104
39,"Virginia Showcase, Virginia Beach Sports Center, Virginia Beach, VA",USA,12 JAN 2024,14 JAN 2024,10,111.0,75076,36,75086
40,"Kirk Baptiste Spring Break Invitational, Tom Tellez Track, Houston, TX",USA,14 MAR 2024,14 MAR 2024,75,58.0,75003,39,75078
41,"Masked Rider Open, Terry & Linda Fuller T&F Complex, Lubbock, TX",USA,22 MAR 2024,23 MAR 2024,45,77.0,74891,41,74936
42,"Africa Games National Trials, Stephen Keshi Stadium, Asaba",NGR,17 FEB 2024,19 FEB 2024,0,,74840,42,74840
43,"WT Jo Meaker Classic & Multi, West Texas A&M University Track & Soccer Complex, Canyon, TX",USA,04 APR 2024,05 APR 2024,0,,74775,43,74775
44,"GC Foster Classic, GC Foster College, Spanish Town",JAM,09 MAR 2024,09 MAR 2024,295,18.0,74301,45,74596
45,"The 57th Tokyo Big 6, Keio Univ. Hiyoshi Athletics Field, Yokohama",JPN,06 APR 2024,07 APR 2024,50,69.0,74357,44,74407
46,"Joe Walker Invitational, Ole Miss T&F Complex, Oxford, MS",USA,05 APR 2024,06 APR 2024,125,40.0,74187,46,74312
47,"Bob Davidson Team Challenge presented by Norris Woody, Dick Vert Stadium, High Point, NC",USA,22 MAR 2024,23 MAR 2024,25,89.0,74133,47,74158
48,"Trojan Invite, USC Cromwell Field at Loker Track Stadium, Los Angeles, CA",USA,22 MAR 2024,23 MAR 2024,90,48.0,74054,48,74144
49,"2º Circuito Paulista OPEN, Centro de Atletismo Professor Oswaldo Terra, Sao Bernardo do Campo",BRA,16 MAR 2024,16 MAR 2024,130,36.0,73151,49,73281
50,"Ole Miss Classic, Ole Miss T&F Complex, Oxford, MS",USA,22 MAR 2024,23 MAR 2024,135,35.0,73140,50,73275
51,"AGN League 5, Pilditch Stadium, Pretoria",RSA,02 MAR 2024,02 MAR 2024,50,69.0,73090,51,73140
52,"UTSA Invitational, Park West Ath. Complex, San Antonio, TX",USA,15 MAR 2024,16 MAR 2024,20,94.0,72695,52,72715
53,"Western Milo Relays, GC Foster College, Spanish Town",JAM,10 FEB 2024,10 FEB 2024,55,67.0,72574,53,72629
54,"Sri Lanka Athletics Open Stage 1, Mahinda Rajapaksha Stadium, Diyagama",SRI,01 MAR 2024,02 MAR 2024,50,69.0,72499,54,72549
55,"AGN League 2, Pilditch Stadium, Pretoria",RSA,27 JAN 2024,27 JAN 2024,85,50.0,72452,55,72537
56,"Continental Tour Ciudad de Santiago, E.Nacional, Santiago de Chile",CHI,31 MAR 2024,31 MAR 2024,305,17.0,72159,59,72464
57,"Sam Howell Invitational, Weaver Stadium, Princeton, NJ",USA,30 MAR 2024,30 MAR 2024,10,111.0,72420,56,72430
58,"2024 Spring Challenge Meet, National Stadium, Tokyo",JPN,15 MAR 2024,17 MAR 2024,15,97.0,72365,57,72380
59,"Yellow Jacket Invitational, Geroge C. Griffin Track, Atlanta, GA",USA,16 MAR 2024,16 MAR 2024,10,111.0,72340,58,72350
60,"Copa Nuevo León Luciano Ramírez Gallardo, Pista del Centro Deportivo Borregos, Estadio Azul ITESM, Monterrey",MEX,24 FEB 2024,25 FEB 2024,90,48.0,72069,60,72159
61,"Beach Opener, Jack Rose Track, Long Beach, CA",USA,01 MAR 2024,02 MAR 2024,55,67.0,71854,61,71909
62,"Central Hurdles Relays & Field Events, GC Foster College, Spanish Town",JAM,20 JAN 2024,20 JAN 2024,60,64.0,71796,63,71856
63,"Corporate Area Development Meet, National Stadium, Kingston",JAM,16 FEB 2024,17 FEB 2024,0,,71812,62,71812
64,"Mangrum Invitational, Mangrum Track & Field, San Marcos, CA",USA,22 MAR 2024,22 MAR 2024,0,,71706,64,71706
65,"Oliver Nikoloff Invitational, Gettler Stadium, Cincinnati, OH",USA,29 MAR 2024,30 MAR 2024,50,69.0,71484,65,71534
66,"Grand Prix Atletica Chilena, E.Nacional, Santiago de Chile",CHI,28 MAR 2024,28 MAR 2024,225,22.0,71230,68,71455
67,"Oregon Preview, Hayward Field, Eugene, OR",USA,22 MAR 2024,23 MAR 2024,10,111.0,71425,66,71435
68,"Charles Austin Classic, Bobcat Track and Field Complex, San Marcos, TX",USA,22 MAR 2024,23 MAR 2024,45,77.0,71308,67,71353
69,"Pre-Africa Games Meet, MKO Abiola National Stadium, Abuja",NGR,02 FEB 2024,03 FEB 2024,0,,71190,69,71190
70,"Velocity Fest 14, National Stadium, Kingston",JAM,16 MAR 2024,16 MAR 2024,620,8.0,70534,78,71154
71,"Alan Connie Shamrock Invitational, Doug Shaw Memorial Stadium, Myrtle Beach, SC",USA,14 MAR 2024,16 MAR 2024,0,,71105,70,71105
72,"22nd National Federation Cup U20, SAI Regional Centre Sarojini Nagar, Lucknow",IND,08 MAR 2024,10 MAR 2024,0,,71033,71,71033
73,"Potts Classic, Hawke's Bay Sports Park, Hastings",NZL,20 JAN 2024,20 JAN 2024,160,29.0,70821,73,70981
74,"3º Encontros de Atletismo, COTP Stadium, São Paulo",BRA,02 MAR 2024,02 MAR 2024,50,69.0,70922,72,70972
75,"AGN League 1, Pilditch Stadium, Pretoria",RSA,20 JAN 2024,20 JAN 2024,45,77.0,70782,74,70827
76,"The Vince O’Boyle Track and Field Classic, Anteater Stadium, Irvine, CA",USA,29 MAR 2024,29 MAR 2024,0,,70733,75,70733
77,"Colorado Invitational, Potts Field, Boulder, CO",USA,05 APR 2024,05 APR 2024,40,80.0,70669,76,70709
78,"Invitational Track and Field Event, National Stadium, Gaborone",BOT,17 FEB 2024,17 FEB 2024,65,61.0,70569,77,70634
79,"Camperdown Classics, National Stadium, Kingston",JAM,10 FEB 2024,10 FEB 2024,140,30.0,70393,79,70533
80,"Queen's/Grace Jackson Track Meet, National Stadium, Kingston",JAM,27 JAN 2024,27 JAN 2024,210,23.0,70180,82,70390
81,"Cathy Freeman Shield, Queensland Sport and Athletics Centre, Nathan, Brisbane",AUS,24 FEB 2024,24 FEB 2024,35,82.0,70345,80,70380
82,"Second Qualifier - LAI, Pista Luis F. Sambolin, San Germán",PUR,22 MAR 2024,23 MAR 2024,20,94.0,70306,81,70326
83,"Youngster Goldsmith National Athletic Classic, National Stadium, Kingston",JAM,03 FEB 2024,03 FEB 2024,15,97.0,69822,83,69837
84,"Dynamic Athletics Outdoor Meet, Navy New Sport Center, Lagos",NGR,27 JAN 2024,27 JAN 2024,0,,69796,84,69796
85,"Ebanks Invitational, George Mason Stadium, Fairfax, VA",USA,05 APR 2024,06 APR 2024,0,,69700,85,69700
86,"Challenger José de Zubiaur, Cef N°3 Hugo Mario La Nasa, Concepción del Uruguay",ARG,06 APR 2024,06 APR 2024,115,42.0,69559,87,69674
87,"Kaohsiung Harbour City Cup National Athletics Championships, National Stadium, Kaohsiung",TPE,23 FEB 2024,27 FEB 2024,10,111.0,69620,86,69630
88,"Porritt Classic, Porritt Stadium, Hamilton",NZL,10 FEB 2024,10 FEB 2024,30,84.0,69522,88,69552
89,"Shocker Spring Invitational, Cessna Stadium, Wichita, KS",USA,29 MAR 2024,30 MAR 2024,50,69.0,69308,90,69358
90,"Joey Haines Invitational, SEMO Abe Stuber T&F Complex, Cape Girardeau, MO",USA,28 MAR 2024,30 MAR 2024,10,111.0,69344,89,69354
91,"The ICALK Athletic Games, Fukuoka University Stadium, Fukuoka",JPN,30 MAR 2024,30 MAR 2024,75,58.0,69133,94,69208
92,"Mark Conover Classic, Miller& Capriotti Athletics Complex, San Luis Obispo, CA",USA,22 MAR 2024,23 MAR 2024,0,,69196,91,69196
93,"Taipei National Spring Athletics Opens, Taipei Municipal Stadium, Taipei City",TPE,01 FEB 2024,05 FEB 2024,5,127.0,69174,92,69179
94,"Jack Christiansen Invitational, CSU Jack Christiansen Track, Fort Collins, CO",USA,29 MAR 2024,30 MAR 2024,0,,69172,93,69172
95,"Cooks Classic, Cooks Gardens, Whanganui",NZL,27 JAN 2024,27 JAN 2024,205,24.0,68602,96,68807
96,"West Coast Relays, Veterans Memorial Stadium, Clovis, CA",USA,22 MAR 2024,23 MAR 2024,10,111.0,68763,95,68773
97,"Capital Classic, Newtown Park Stadium, Wellington",NZL,02 FEB 2024,02 FEB 2024,170,27.0,68457,98,68627
98,"National Athletics Series 3, National Stadium, Gaborone",BOT,10 FEB 2024,10 FEB 2024,10,111.0,68548,97,68558
99,"Algerian Winter Championships, Miloud HEDEFI Athletics Stadium, Oran",ALG,01 MAR 2024,02 MAR 2024,30,84.0,68264,99,68294
100,"Virginia Triangular, UVA Lanningan Field, Charlottesville, VA",USA,23 MAR 2024,23 MAR 2024,0,,68224,100,68224
