Place,Competition,Country,Start Date,End Date,Part. Score,P.S. Place,Result Score,R.S. Place,Comp. Score
1,"Clyde Littlefield Texas Relays presented by Truist, Mike A. Myers Stadium, Austin, TX",USA,27 MAR 2024,30 MAR 2024,1305,3.0,83819,1,85124
2,"Pepsi Florida Relays, Percy Beard Track, Gainesville, FL",USA,29 MAR 2024,30 MAR 2024,795,4.0,83536,2,84331
3,"Battle on the Bayou, LSU Bernie Moore Stadium, Baton Rouge, LA",USA,29 MAR 2024,30 MAR 2024,465,12.0,82292,3,82757
4,"Miramar Invitational, Ansin Sports Complex, Miramar, FL",USA,06 APR 2024,06 APR 2024,1695,1.0,81011,4,82706
5,"Maurie Plant Meet, Lakeside Stadium, Melbourne",AUS,15 FEB 2024,15 FEB 2024,1460,2.0,79614,7,81074
6,"Sydney Track Classic, ES Marks Athletics Field, Sydney",AUS,23 MAR 2024,23 MAR 2024,570,9.0,79897,5,80467
7,"Adelaide Invitational, SA Athletic Stadium, Adelaide",AUS,10 FEB 2024,10 FEB 2024,730,5.0,79659,6,80389
8,"ASA Athletics Grand Prix 3 / Continental Tour Challenger, UJ Stadium, Johannesburg",RSA,27 MAR 2024,27 MAR 2024,505,11.0,79175,10,79680
9,"Stanford Invitational, Cobb Track and Angell Field, Palo Alto, CA",USA,29 MAR 2024,30 MAR 2024,240,22.0,79295,9,79535
10,"Trials for African Games 2024, Nyayo National Stadium, Nairobi",KEN,05 MAR 2024,06 MAR 2024,715,7.0,78802,12,79517
11,"Raleigh Relays, Paul Derr TF Facility, Raleigh, NC",USA,28 MAR 2024,30 MAR 2024,85,55.0,79400,8,79485
12,"Canberra Track Classic, AIS Athletics Track, Canberra",AUS,01 MAR 2024,02 MAR 2024,345,16.0,78829,11,79174
13,"Hurricane Invitational, UMiami Cobb Stadium, Coral Gables, FL",USA,15 MAR 2024,16 MAR 2024,420,13.0,78509,14,78929
14,"USF Alumni Invitational, University of South Florida Track & Field Stadium, Tampa, FL",USA,15 MAR 2024,16 MAR 2024,35,88.0,78708,13,78743
15,"Bobcat Invitational, Bobcat Track and Field Complex, San Marcos, TX",USA,28 MAR 2024,30 MAR 2024,105,45.0,78034,16,78139
16,"Crimson Tide Invitational, Sam Bailey Track Stadium, Tuscaloosa, AL",USA,05 APR 2024,06 APR 2024,65,66.0,78054,15,78119
17,"ASA Athletics Grand Prix 2, Bestmed Tuks Stadium, Pretoria",RSA,18 MAR 2024,18 MAR 2024,195,26.0,77884,17,78079
18,"ASA Athletics Grand Prix 1, McArthur Stadium, Potchefstroom",RSA,14 MAR 2024,14 MAR 2024,420,13.0,77488,22,77908
19,"Arizona Spring Break Fiesta, Univ. of Arizona Roy P. Drachman Stadium, Tucson, AZ",USA,16 MAR 2024,16 MAR 2024,140,31.0,77637,19,77777
20,"UCF Black & Gold Invite, UCF Soccer and Track Complex, Orlando, FL",USA,15 MAR 2024,16 MAR 2024,30,90.0,77643,18,77673
21,"Willie Williams Classic, Univ. of Arizona Roy P. Drachman Stadium, Tucson, AZ",USA,22 MAR 2024,23 MAR 2024,80,58.0,77570,20,77650
22,"Clyde Hart Classic, Clyde Hart Track & Field Stadium, Waco, TX",USA,22 MAR 2024,23 MAR 2024,95,51.0,77537,21,77632
23,"International Track Meet, Nga Puna Wai Sports Hub, Christchurch",NZL,24 FEB 2024,24 FEB 2024,730,5.0,76829,27,77559
24,"3rd AK Track And Field Weekend Meeting, Nyayo National Stadium, Nairobi",KEN,26 JAN 2024,27 JAN 2024,310,17.0,77245,23,77555
25,"Sir Graeme Douglas Memorial Track Classic, Douglas Track & Field, Auckland",NZL,10 MAR 2024,10 MAR 2024,560,10.0,76891,26,77451
26,"Keyth Talley Invitational, LSU Bernie Moore Stadium, Baton Rouge, LA",USA,23 MAR 2024,23 MAR 2024,130,37.0,77209,24,77339
27,"Jim Click Shootout & Multis, Univ. of Arizona Roy P. Drachman Stadium, Tucson, AZ",USA,05 APR 2024,06 APR 2024,130,37.0,77071,25,77201
28,"Hurricane Collegiate Invitational, UMiami Cobb Stadium, Coral Gables, FL",USA,23 MAR 2024,23 MAR 2024,265,21.0,76764,29,77029
29,"UCF Knights Invite, UCF Soccer and Track Complex, Orlando, FL",USA,22 MAR 2024,23 MAR 2024,60,69.0,76815,28,76875
30,"UC San Diego Triton Invitational, Triton Stadium, San Diego, CA",USA,05 APR 2024,06 APR 2024,410,15.0,76077,31,76487
31,"2nd AK Track & Field Weekend Meeting/AK Relay Series, Ulinzi Sports Complex, Langata, Nairobi",KEN,05 JAN 2024,06 JAN 2024,105,45.0,76347,30,76452
32,"Aztec Invitational, San Diego State University, San Diego, CA",USA,21 MAR 2024,23 MAR 2024,270,20.0,75472,33,75742
33,"AGN League 3, Pilditch Stadium, Pretoria",RSA,10 FEB 2024,10 FEB 2024,140,31.0,75547,32,75687
34,"Texas A&M Invitational, Cushing Stadium, College Station, TX",USA,23 MAR 2024,23 MAR 2024,80,58.0,75443,34,75523
35,"18th Spring Break Classic, Pista Basilio Rodriguez, Carolina",PUR,14 MAR 2024,16 MAR 2024,195,26.0,75318,35,75513
36,"FSU Relays, Florida State University - Mike Long Track, Tallahassee, FL",USA,21 MAR 2024,22 MAR 2024,85,55.0,75184,37,75269
37,"JAAA CARIFTA Trials, National Stadium, Kingston",JAM,01 MAR 2024,03 MAR 2024,0,,75256,36,75256
38,"Arkansas Spring Invitational, John McDonnell Field, Fayetteville, AR",USA,06 APR 2024,06 APR 2024,120,43.0,75065,39,75185
39,"AGN League 4, Pilditch Stadium, Pretoria",RSA,24 FEB 2024,24 FEB 2024,105,45.0,75064,40,75169
40,"Curro Podium Final, Pilditch Stadium, Pretoria",RSA,17 FEB 2024,17 FEB 2024,165,29.0,74939,42,75104
41,"Virginia Showcase, Virginia Beach Sports Center, Virginia Beach, VA",USA,12 JAN 2024,14 JAN 2024,10,117.0,75076,38,75086
42,"Kirk Baptiste Spring Break Invitational, Tom Tellez Track, Houston, TX",USA,14 MAR 2024,14 MAR 2024,75,63.0,75003,41,75078
43,"Masked Rider Open, Terry & Linda Fuller T&F Complex, Lubbock, TX",USA,22 MAR 2024,23 MAR 2024,45,82.0,74891,43,74936
44,"Africa Games National Trials, Stephen Keshi Stadium, Asaba",NGR,17 FEB 2024,19 FEB 2024,0,,74840,44,74840
45,"WT Jo Meaker Classic & Multi, West Texas A&M University Track & Soccer Complex, Canyon, TX",USA,04 APR 2024,05 APR 2024,0,,74775,45,74775
46,"GC Foster Classic, GC Foster College, Spanish Town",JAM,09 MAR 2024,09 MAR 2024,295,19.0,74301,47,74596
47,"The 57th Tokyo Big 6, Keio Univ. Hiyoshi Athletics Field, Yokohama",JPN,06 APR 2024,07 APR 2024,50,74.0,74357,46,74407
48,"Joe Walker Invitational, Ole Miss T&F Complex, Oxford, MS",USA,05 APR 2024,06 APR 2024,125,42.0,74187,48,74312
49,"Bob Davidson Team Challenge presented by Norris Woody, Dick Vert Stadium, High Point, NC",USA,22 MAR 2024,23 MAR 2024,25,95.0,74133,49,74158
50,"Trojan Invite, USC Cromwell Field at Loker Track Stadium, Los Angeles, CA",USA,22 MAR 2024,23 MAR 2024,90,52.0,74054,50,74144
51,"2º Circuito Paulista OPEN, Centro de Atletismo Professor Oswaldo Terra, Sao Bernardo do Campo",BRA,16 MAR 2024,16 MAR 2024,130,37.0,73151,51,73281
52,"Ole Miss Classic, Ole Miss T&F Complex, Oxford, MS",USA,22 MAR 2024,23 MAR 2024,135,36.0,73140,52,73275
53,"AGN League 5, Pilditch Stadium, Pretoria",RSA,02 MAR 2024,02 MAR 2024,50,74.0,73090,53,73140
54,"UTSA Invitational, Park West Ath. Complex, San Antonio, TX",USA,15 MAR 2024,16 MAR 2024,20,100.0,72695,54,72715
55,"Western Milo Relays, GC Foster College, Spanish Town",JAM,10 FEB 2024,10 FEB 2024,55,72.0,72574,55,72629
56,"Sri Lanka Athletics Open Stage 1, Mahinda Rajapaksha Stadium, Diyagama",SRI,01 MAR 2024,02 MAR 2024,50,74.0,72499,56,72549
57,"AGN League 2, Pilditch Stadium, Pretoria",RSA,27 JAN 2024,27 JAN 2024,85,55.0,72452,57,72537
58,"Continental Tour Ciudad de Santiago, E.Nacional, Santiago de Chile",CHI,31 MAR 2024,31 MAR 2024,305,18.0,72159,61,72464
59,"Sam Howell Invitational, Weaver Stadium, Princeton, NJ",USA,30 MAR 2024,30 MAR 2024,10,117.0,72420,58,72430
60,"2024 Spring Challenge Meet, National Stadium, Tokyo",JPN,15 MAR 2024,17 MAR 2024,15,103.0,72365,59,72380
61,"Yellow Jacket Invitational, Geroge C. Griffin Track, Atlanta, GA",USA,16 MAR 2024,16 MAR 2024,10,117.0,72340,60,72350
62,"Copa Nuevo León Luciano Ramírez Gallardo, Pista del Centro Deportivo Borregos, Estadio Azul ITESM, Monterrey",MEX,24 FEB 2024,25 FEB 2024,90,52.0,72069,62,72159
63,"Beach Opener, Jack Rose Track, Long Beach, CA",USA,01 MAR 2024,02 MAR 2024,55,72.0,71854,64,71909
64,"41th Tokai University-Nihon University Game, Nihon University Athletics Stadium, Setagaya",JPN,07 APR 2024,07 APR 2024,0,,71891,63,71891
65,"Central Hurdles Relays & Field Events, GC Foster College, Spanish Town",JAM,20 JAN 2024,20 JAN 2024,60,69.0,71796,66,71856
66,"Corporate Area Development Meet, National Stadium, Kingston",JAM,16 FEB 2024,17 FEB 2024,0,,71812,65,71812
67,"Mangrum Invitational, Mangrum Track & Field, San Marcos, CA",USA,22 MAR 2024,22 MAR 2024,0,,71706,67,71706
68,"UNLV Rebels Elite, Myron Partridge Stadium & Sheila Tarr-Smith Field, Las Vegas, NV",USA,05 APR 2024,06 APR 2024,100,48.0,71469,69,71569
69,"Oliver Nikoloff Invitational, Gettler Stadium, Cincinnati, OH",USA,29 MAR 2024,30 MAR 2024,50,74.0,71484,68,71534
70,"Grand Prix Atletica Chilena, E.Nacional, Santiago de Chile",CHI,28 MAR 2024,28 MAR 2024,225,23.0,71230,72,71455
71,"Oregon Preview, Hayward Field, Eugene, OR",USA,22 MAR 2024,23 MAR 2024,10,117.0,71425,70,71435
72,"Charles Austin Classic, Bobcat Track and Field Complex, San Marcos, TX",USA,22 MAR 2024,23 MAR 2024,45,82.0,71308,71,71353
73,"Pre-Africa Games Meet, MKO Abiola National Stadium, Abuja",NGR,02 FEB 2024,03 FEB 2024,0,,71190,73,71190
74,"Velocity Fest 14, National Stadium, Kingston",JAM,16 MAR 2024,16 MAR 2024,620,8.0,70534,82,71154
75,"Alan Connie Shamrock Invitational, Doug Shaw Memorial Stadium, Myrtle Beach, SC",USA,14 MAR 2024,16 MAR 2024,0,,71105,74,71105
76,"22nd National Federation Cup U20, SAI Regional Centre Sarojini Nagar, Lucknow",IND,08 MAR 2024,10 MAR 2024,0,,71033,75,71033
77,"Potts Classic, Hawke's Bay Sports Park, Hastings",NZL,20 JAN 2024,20 JAN 2024,160,30.0,70821,77,70981
78,"3º Encontros de Atletismo, COTP Stadium, São Paulo",BRA,02 MAR 2024,02 MAR 2024,50,74.0,70922,76,70972
79,"AGN League 1, Pilditch Stadium, Pretoria",RSA,20 JAN 2024,20 JAN 2024,45,82.0,70782,78,70827
80,"The Vince O’Boyle Track and Field Classic, Anteater Stadium, Irvine, CA",USA,29 MAR 2024,29 MAR 2024,0,,70733,79,70733
81,"Colorado Invitational, Potts Field, Boulder, CO",USA,05 APR 2024,05 APR 2024,40,85.0,70669,80,70709
82,"Invitational Track and Field Event, National Stadium, Gaborone",BOT,17 FEB 2024,17 FEB 2024,65,66.0,70569,81,70634
83,"Camperdown Classics, National Stadium, Kingston",JAM,10 FEB 2024,10 FEB 2024,140,31.0,70393,83,70533
84,"Pomona-Pitzer Track & Field Invitational, Strehle Track, Pomona College, Claremont, CA",USA,06 APR 2024,06 APR 2024,40,85.0,70352,84,70392
85,"Queen's/Grace Jackson Track Meet, National Stadium, Kingston",JAM,27 JAN 2024,27 JAN 2024,210,24.0,70180,87,70390
86,"Cathy Freeman Shield, Queensland Sport and Athletics Centre, Nathan, Brisbane",AUS,24 FEB 2024,24 FEB 2024,35,88.0,70345,85,70380
87,"Second Qualifier - LAI, Pista Luis F. Sambolin, San Germán",PUR,22 MAR 2024,23 MAR 2024,20,100.0,70306,86,70326
88,"Youngster Goldsmith National Athletic Classic, National Stadium, Kingston",JAM,03 FEB 2024,03 FEB 2024,15,103.0,69822,88,69837
89,"Dynamic Athletics Outdoor Meet, Navy New Sport Center, Lagos",NGR,27 JAN 2024,27 JAN 2024,0,,69796,89,69796
90,"Ebanks Invitational, George Mason Stadium, Fairfax, VA",USA,05 APR 2024,06 APR 2024,0,,69700,90,69700
91,"Challenger José de Zubiaur, Cef N°3 Hugo Mario La Nasa, Concepción del Uruguay",ARG,06 APR 2024,06 APR 2024,115,44.0,69559,92,69674
92,"Kaohsiung Harbour City Cup National Athletics Championships, National Stadium, Kaohsiung",TPE,23 FEB 2024,27 FEB 2024,10,117.0,69620,91,69630
93,"Porritt Classic, Porritt Stadium, Hamilton",NZL,10 FEB 2024,10 FEB 2024,30,90.0,69522,93,69552
94,"Shocker Spring Invitational, Cessna Stadium, Wichita, KS",USA,29 MAR 2024,30 MAR 2024,50,74.0,69308,95,69358
95,"Joey Haines Invitational, SEMO Abe Stuber T&F Complex, Cape Girardeau, MO",USA,28 MAR 2024,30 MAR 2024,10,117.0,69344,94,69354
96,"The ICALK Athletic Games, Fukuoka University Stadium, Fukuoka",JPN,30 MAR 2024,30 MAR 2024,75,63.0,69133,99,69208
97,"Mark Conover Classic, Miller& Capriotti Athletics Complex, San Luis Obispo, CA",USA,22 MAR 2024,23 MAR 2024,0,,69196,96,69196
98,"Taipei National Spring Athletics Opens, Taipei Municipal Stadium, Taipei City",TPE,01 FEB 2024,05 FEB 2024,5,133.0,69174,97,69179
99,"Jack Christiansen Invitational, CSU Jack Christiansen Track, Fort Collins, CO",USA,29 MAR 2024,30 MAR 2024,0,,69172,98,69172
100,"Cooks Classic, Cooks Gardens, Whanganui",NZL,27 JAN 2024,27 JAN 2024,205,25.0,68602,101,68807
