Place,Competition,Country,Start Date,End Date,Part. Score,P.S. Place,Result Score,R.S. Place,Comp. Score
1,"Tom Jones Memorial, Percy Beard Track, Gainesville, FL",USA,12 APR 2024,13 APR 2024,2310,1.0,86012,1,88322
2,"Clyde Littlefield Texas Relays presented by Truist, Mike A. Myers Stadium, Austin, TX",USA,27 MAR 2024,30 MAR 2024,1305,4.0,83819,2,85124
3,"Pepsi Florida Relays, Percy Beard Track, Gainesville, FL",USA,29 MAR 2024,30 MAR 2024,795,6.0,83536,3,84331
4,"Bryan Clay Invitational, Cougar Athletic Stadium, Azusa, CA",USA,11 APR 2024,13 APR 2024,920,5.0,82012,5,82932
5,"Battle on the Bayou, LSU Bernie Moore Stadium, Baton Rouge, LA",USA,29 MAR 2024,30 MAR 2024,465,14.0,82292,4,82757
6,"Miramar Invitational, Ansin Sports Complex, Miramar, FL",USA,06 APR 2024,06 APR 2024,1695,2.0,81011,6,82706
7,"Maurie Plant Meet, Lakeside Stadium, Melbourne",AUS,15 FEB 2024,15 FEB 2024,1460,3.0,79614,9,81074
8,"Sydney Track Classic, ES Marks Athletics Field, Sydney",AUS,23 MAR 2024,23 MAR 2024,570,11.0,79897,7,80467
9,"Adelaide Invitational, SA Athletic Stadium, Adelaide",AUS,10 FEB 2024,10 FEB 2024,730,7.0,79659,8,80389
10,"ASA Athletics Grand Prix 3 / Continental Tour Challenger, UJ Stadium, Johannesburg",RSA,27 MAR 2024,27 MAR 2024,505,13.0,79175,12,79680
11,"Stanford Invitational, Cobb Track and Angell Field, Palo Alto, CA",USA,29 MAR 2024,30 MAR 2024,240,30.0,79295,11,79535
12,"Trials for African Games 2024, Nyayo National Stadium, Nairobi",KEN,05 MAR 2024,06 MAR 2024,715,9.0,78802,14,79517
13,"Raleigh Relays, Paul Derr TF Facility, Raleigh, NC",USA,28 MAR 2024,30 MAR 2024,85,73.0,79400,10,79485
14,"Canberra Track Classic, AIS Athletics Track, Canberra",AUS,01 MAR 2024,02 MAR 2024,345,21.0,78829,13,79174
15,"Hurricane Invitational, UMiami Cobb Stadium, Coral Gables, FL",USA,15 MAR 2024,16 MAR 2024,420,15.0,78509,16,78929
16,"Hurricane Alumni Invitational, UMiami Cobb Stadium, Coral Gables, FL",USA,05 APR 2024,06 APR 2024,415,17.0,78349,19,78764
17,"USF Alumni Invitational, University of South Florida Track & Field Stadium, Tampa, FL",USA,15 MAR 2024,16 MAR 2024,35,112.0,78708,15,78743
18,"44 Farms Team Invitational, Cushing Stadium, College Station, TX",USA,05 APR 2024,06 APR 2024,225,31.0,78479,18,78704
19,"Duke Invitational, Morris Williams T&F Stadium, Durham, NC",USA,11 APR 2024,13 APR 2024,75,82.0,78500,17,78575
20,"National Athletics Grand Prix 1, Zhaoqing Sports Center, Zhaoqing",CHN,09 APR 2024,10 APR 2024,340,22.0,77926,23,78266
21,"Beach Invitational, Jack Rose Track, Long Beach, CA",USA,12 APR 2024,13 APR 2024,280,27.0,77968,22,78248
22,"Bobcat Invitational, Bobcat Track and Field Complex, San Marcos, TX",USA,28 MAR 2024,30 MAR 2024,105,60.0,78034,21,78139
23,"Crimson Tide Invitational, Sam Bailey Track Stadium, Tuscaloosa, AL",USA,05 APR 2024,06 APR 2024,65,86.0,78054,20,78119
24,"ASA Athletics Grand Prix 2, Bestmed Tuks Stadium, Pretoria",RSA,18 MAR 2024,18 MAR 2024,195,35.0,77884,24,78079
25,"Troféu Adhemar Ferreira da Silva Loterias Caixa de Atletismo, CNDA, Bragança Paulista",BRA,05 APR 2024,07 APR 2024,410,18.0,77626,27,78036
26,"ASA Athletics Grand Prix 1, McArthur Stadium, Potchefstroom",RSA,14 MAR 2024,14 MAR 2024,420,15.0,77488,31,77908
27,"Arizona Spring Break Fiesta, Univ. of Arizona Roy P. Drachman Stadium, Tucson, AZ",USA,16 MAR 2024,16 MAR 2024,140,43.0,77637,26,77777
28,"South Florida Invitational, University of South Florida Track & Field Stadium, Tampa, FL",USA,05 APR 2024,06 APR 2024,185,37.0,77518,30,77703
29,"UCF Black & Gold Invite, UCF Soccer and Track Complex, Orlando, FL",USA,15 MAR 2024,16 MAR 2024,30,119.0,77643,25,77673
30,"Willie Williams Classic, Univ. of Arizona Roy P. Drachman Stadium, Tucson, AZ",USA,22 MAR 2024,23 MAR 2024,80,76.0,77570,28,77650
31,"Clyde Hart Classic, Clyde Hart Track & Field Stadium, Waco, TX",USA,22 MAR 2024,23 MAR 2024,95,66.0,77537,29,77632
32,"International Track Meet, Nga Puna Wai Sports Hub, Christchurch",NZL,24 FEB 2024,24 FEB 2024,730,7.0,76829,37,77559
33,"3rd AK Track And Field Weekend Meeting, Nyayo National Stadium, Nairobi",KEN,26 JAN 2024,27 JAN 2024,310,23.0,77245,33,77555
34,"Pacific Coast Invitational, Jack Rose Track, Long Beach, CA",USA,11 APR 2024,11 APR 2024,120,56.0,77353,32,77473
35,"Sir Graeme Douglas Memorial Track Classic, Douglas Track & Field, Auckland",NZL,10 MAR 2024,10 MAR 2024,560,12.0,76891,36,77451
36,"Keyth Talley Invitational, LSU Bernie Moore Stadium, Baton Rouge, LA",USA,23 MAR 2024,23 MAR 2024,130,49.0,77209,34,77339
37,"Jim Click Shootout & Multis, Univ. of Arizona Roy P. Drachman Stadium, Tucson, AZ",USA,05 APR 2024,06 APR 2024,130,49.0,77071,35,77201
38,"Hurricane Collegiate Invitational, UMiami Cobb Stadium, Coral Gables, FL",USA,23 MAR 2024,23 MAR 2024,265,29.0,76764,39,77029
39,"UCF Knights Invite, UCF Soccer and Track Complex, Orlando, FL",USA,22 MAR 2024,23 MAR 2024,60,90.0,76815,38,76875
40,"UC San Diego Triton Invitational, Triton Stadium, San Diego, CA",USA,05 APR 2024,06 APR 2024,410,18.0,76077,41,76487
41,"2nd AK Track & Field Weekend Meeting/AK Relay Series, Ulinzi Sports Complex, Langata, Nairobi",KEN,05 JAN 2024,06 JAN 2024,105,60.0,76347,40,76452
42,"Cameron Burrell Alumni Invitational, Carl Lewis TF and Soccer Complex, Houston, TX",USA,06 APR 2024,06 APR 2024,305,24.0,75626,42,75931
43,"Aztec Invitational, San Diego State University, San Diego, CA",USA,21 MAR 2024,23 MAR 2024,270,28.0,75472,44,75742
44,"AGN League 3, Pilditch Stadium, Pretoria",RSA,10 FEB 2024,10 FEB 2024,140,43.0,75547,43,75687
45,"Texas A&M Invitational, Cushing Stadium, College Station, TX",USA,23 MAR 2024,23 MAR 2024,80,76.0,75443,45,75523
46,"18th Spring Break Classic, Pista Basilio Rodriguez, Carolina",PUR,14 MAR 2024,16 MAR 2024,195,35.0,75318,46,75513
47,"FSU Relays, Florida State University - Mike Long Track, Tallahassee, FL",USA,21 MAR 2024,22 MAR 2024,85,73.0,75184,48,75269
48,"JAAA CARIFTA Trials, National Stadium, Kingston",JAM,01 MAR 2024,03 MAR 2024,0,,75256,47,75256
49,"Arkansas Spring Invitational, John McDonnell Field, Fayetteville, AR",USA,06 APR 2024,06 APR 2024,120,56.0,75065,50,75185
50,"AGN League 4, Pilditch Stadium, Pretoria",RSA,24 FEB 2024,24 FEB 2024,105,60.0,75064,51,75169
51,"Curro Podium Final, Pilditch Stadium, Pretoria",RSA,17 FEB 2024,17 FEB 2024,165,39.0,74939,54,75104
52,"VertKlasse Meeting, Dick Vert Stadium, High Point, NC",USA,05 APR 2024,06 APR 2024,160,40.0,74928,55,75088
53,"Virginia Showcase, Virginia Beach Sports Center, Virginia Beach, VA",USA,12 JAN 2024,14 JAN 2024,10,153.0,75076,49,75086
54,"Kirk Baptiste Spring Break Invitational, Tom Tellez Track, Houston, TX",USA,14 MAR 2024,14 MAR 2024,75,82.0,75003,53,75078
55,"John Jacobs Invitational, John Jacobs Track Complex, Norman, OK",USA,12 APR 2024,13 APR 2024,35,112.0,75039,52,75074
56,"Masked Rider Open, Terry & Linda Fuller T&F Complex, Lubbock, TX",USA,22 MAR 2024,23 MAR 2024,45,105.0,74891,56,74936
57,"Gary Wieneke Memorial, Demirjian Park, Champaign, IL",USA,13 APR 2024,13 APR 2024,125,54.0,74799,58,74924
58,"Africa Games National Trials, Stephen Keshi Stadium, Asaba",NGR,17 FEB 2024,19 FEB 2024,0,,74840,57,74840
59,"60th Four University Inter-College Track and Field Tournament, Gion Stadium, Sagamihara",JPN,14 APR 2024,14 APR 2024,15,135.0,74796,59,74811
60,"WT Jo Meaker Classic & Multi, West Texas A&M University Track & Soccer Complex, Canyon, TX",USA,04 APR 2024,05 APR 2024,0,,74775,60,74775
61,"Tennessee Invite, Tom Black Track at LaPorte Stadium, Knoxville, TN",USA,05 APR 2024,06 APR 2024,30,119.0,74692,61,74722
62,"GC Foster Classic, GC Foster College, Spanish Town",JAM,09 MAR 2024,09 MAR 2024,295,26.0,74301,63,74596
63,"The 57th Tokyo Big 6, Keio Univ. Hiyoshi Athletics Field, Yokohama",JPN,06 APR 2024,07 APR 2024,50,96.0,74357,62,74407
64,"Joe Walker Invitational, Ole Miss T&F Complex, Oxford, MS",USA,05 APR 2024,06 APR 2024,125,54.0,74187,64,74312
65,"Bob Davidson Team Challenge presented by Norris Woody, Dick Vert Stadium, High Point, NC",USA,22 MAR 2024,23 MAR 2024,25,126.0,74133,65,74158
66,"Trojan Invite, USC Cromwell Field at Loker Track Stadium, Los Angeles, CA",USA,22 MAR 2024,23 MAR 2024,90,69.0,74054,66,74144
67,"2º Circuito Paulista OPEN, Centro de Atletismo Professor Oswaldo Terra, Sao Bernardo do Campo",BRA,16 MAR 2024,16 MAR 2024,130,49.0,73151,67,73281
68,"Ole Miss Classic, Ole Miss T&F Complex, Oxford, MS",USA,22 MAR 2024,23 MAR 2024,135,48.0,73140,68,73275
69,"AGN League 5, Pilditch Stadium, Pretoria",RSA,02 MAR 2024,02 MAR 2024,50,96.0,73090,69,73140
70,"Continental Tour Semana del Mar, Pista de Atletismo Justo Román, Mar del Plata",ARG,10 APR 2024,10 APR 2024,365,20.0,72637,71,73002
71,"UTSA Invitational, Park West Ath. Complex, San Antonio, TX",USA,15 MAR 2024,16 MAR 2024,20,131.0,72695,70,72715
72,"Western Milo Relays, GC Foster College, Spanish Town",JAM,10 FEB 2024,10 FEB 2024,55,94.0,72574,72,72629
73,"Sri Lanka Athletics Open Stage 1, Mahinda Rajapaksha Stadium, Diyagama",SRI,01 MAR 2024,02 MAR 2024,50,96.0,72499,73,72549
74,"AGN League 2, Pilditch Stadium, Pretoria",RSA,27 JAN 2024,27 JAN 2024,85,73.0,72452,74,72537
75,"Continental Tour Ciudad de Santiago, E.Nacional, Santiago de Chile",CHI,31 MAR 2024,31 MAR 2024,305,24.0,72159,81,72464
76,"Sam Howell Invitational, Weaver Stadium, Princeton, NJ",USA,30 MAR 2024,30 MAR 2024,10,153.0,72420,75,72430
77,"2024 Spring Challenge Meet, National Stadium, Tokyo",JPN,15 MAR 2024,17 MAR 2024,15,135.0,72365,76,72380
78,"Virginia Grand Prix, UVA Lanningan Field, Charlottesville, VA",USA,12 APR 2024,13 APR 2024,10,153.0,72349,77,72359
79,"Yellow Jacket Invitational, Geroge C. Griffin Track, Atlanta, GA",USA,16 MAR 2024,16 MAR 2024,10,153.0,72340,78,72350
80,"17th Iwakabe Cup, Athletic Park, Ageo",JPN,07 APR 2024,07 APR 2024,45,105.0,72284,79,72329
81,"Encuentro FMAA César Moreno Bravo 2024, Centro Deportivo Olímpico Mexicano, Ciudad de México",MEX,05 APR 2024,07 APR 2024,10,153.0,72271,80,72281
82,"Copa Nuevo León Luciano Ramírez Gallardo, Pista del Centro Deportivo Borregos, Estadio Azul ITESM, Monterrey",MEX,24 FEB 2024,25 FEB 2024,90,69.0,72069,82,72159
83,"New Taipei City Youth Cup National Athletics Opens, Banqiao Stadium, New Taipei City",TPE,04 MAR 2024,08 MAR 2024,35,112.0,71879,84,71914
84,"Beach Opener, Jack Rose Track, Long Beach, CA",USA,01 MAR 2024,02 MAR 2024,55,94.0,71854,85,71909
85,"41th Tokai University-Nihon University Game, Nihon University Athletics Stadium, Setagaya",JPN,07 APR 2024,07 APR 2024,0,,71891,83,71891
86,"Central Hurdles Relays & Field Events, GC Foster College, Spanish Town",JAM,20 JAN 2024,20 JAN 2024,60,90.0,71796,87,71856
87,"Corporate Area Development Meet, National Stadium, Kingston",JAM,16 FEB 2024,17 FEB 2024,0,,71812,86,71812
88,"Mangrum Invitational, Mangrum Track & Field, San Marcos, CA",USA,22 MAR 2024,22 MAR 2024,0,,71706,88,71706
89,"UNLV Rebels Elite, Myron Partridge Stadium & Sheila Tarr-Smith Field, Las Vegas, NV",USA,05 APR 2024,06 APR 2024,100,63.0,71469,90,71569
90,"Oliver Nikoloff Invitational, Gettler Stadium, Cincinnati, OH",USA,29 MAR 2024,30 MAR 2024,50,96.0,71484,89,71534
91,"Grand Prix Atletica Chilena, E.Nacional, Santiago de Chile",CHI,28 MAR 2024,28 MAR 2024,225,31.0,71230,93,71455
92,"Oregon Preview, Hayward Field, Eugene, OR",USA,22 MAR 2024,23 MAR 2024,10,153.0,71425,91,71435
93,"Charles Austin Classic, Bobcat Track and Field Complex, San Marcos, TX",USA,22 MAR 2024,23 MAR 2024,45,105.0,71308,92,71353
94,"USD Early Bird, Mildred J. Hillenbrand Memorial Track, Vermillion, SD",USA,05 APR 2024,06 APR 2024,35,112.0,71190,94,71225
95,"Pre-Africa Games Meet, MKO Abiola National Stadium, Abuja",NGR,02 FEB 2024,03 FEB 2024,0,,71190,94,71190
96,"Velocity Fest 14, National Stadium, Kingston",JAM,16 MAR 2024,16 MAR 2024,620,10.0,70534,106,71154
97,"54th Hokuriku Corporate team Competition, Niigatashi Field, Niigata",JPN,06 APR 2024,07 APR 2024,80,76.0,71041,97,71121
98,"Alan Connie Shamrock Invitational, Doug Shaw Memorial Stadium, Myrtle Beach, SC",USA,14 MAR 2024,16 MAR 2024,0,,71105,96,71105
99,"22nd National Federation Cup U20, SAI Regional Centre Sarojini Nagar, Lucknow",IND,08 MAR 2024,10 MAR 2024,0,,71033,98,71033
100,"Potts Classic, Hawke's Bay Sports Park, Hastings",NZL,20 JAN 2024,20 JAN 2024,160,40.0,70821,101,70981
