Place,Competition,Country,Start Date,End Date,Part. Score,P.S. Place,Result Score,R.S. Place,Comp. Score
1,"Clyde Littlefield Texas Relays presented by Truist, Mike A. Myers Stadium, Austin, TX",USA,27 MAR 2024,30 MAR 2024,1305,3.0,83819,1,85124
2,"Pepsi Florida Relays, Percy Beard Track, Gainesville, FL",USA,29 MAR 2024,30 MAR 2024,795,4.0,83536,2,84331
3,"Battle on the Bayou, LSU Bernie Moore Stadium, Baton Rouge, LA",USA,29 MAR 2024,30 MAR 2024,465,13.0,82292,3,82757
4,"Miramar Invitational, Ansin Sports Complex, Miramar, FL",USA,06 APR 2024,06 APR 2024,1695,1.0,81011,4,82706
5,"Maurie Plant Meet, Lakeside Stadium, Melbourne",AUS,15 FEB 2024,15 FEB 2024,1460,2.0,79614,7,81074
6,"Sydney Track Classic, ES Marks Athletics Field, Sydney",AUS,23 MAR 2024,23 MAR 2024,570,10.0,79897,5,80467
7,"Adelaide Invitational, SA Athletic Stadium, Adelaide",AUS,10 FEB 2024,10 FEB 2024,730,5.0,79659,6,80389
8,"ASA Athletics Grand Prix 3 / Continental Tour Challenger, UJ Stadium, Johannesburg",RSA,27 MAR 2024,27 MAR 2024,505,12.0,79175,10,79680
9,"Stanford Invitational, Cobb Track and Angell Field, Palo Alto, CA",USA,29 MAR 2024,30 MAR 2024,240,26.0,79295,9,79535
10,"Trials for African Games 2024, Nyayo National Stadium, Nairobi",KEN,05 MAR 2024,06 MAR 2024,715,7.0,78802,12,79517
11,"Raleigh Relays, Paul Derr TF Facility, Raleigh, NC",USA,28 MAR 2024,30 MAR 2024,85,64.0,79400,8,79485
12,"Canberra Track Classic, AIS Athletics Track, Canberra",AUS,01 MAR 2024,02 MAR 2024,345,19.0,78829,11,79174
13,"Hurricane Alumni Invitational, UMiami Cobb Stadium, Coral Gables, FL",USA,05 APR 2024,06 APR 2024,630,8.0,78371,16,79001
14,"Hurricane Invitational, UMiami Cobb Stadium, Coral Gables, FL",USA,15 MAR 2024,16 MAR 2024,420,14.0,78509,14,78929
15,"USF Alumni Invitational, University of South Florida Track & Field Stadium, Tampa, FL",USA,15 MAR 2024,16 MAR 2024,35,99.0,78708,13,78743
16,"44 Farms Team Invitational, Cushing Stadium, College Station, TX",USA,05 APR 2024,06 APR 2024,225,27.0,78479,15,78704
17,"Bobcat Invitational, Bobcat Track and Field Complex, San Marcos, TX",USA,28 MAR 2024,30 MAR 2024,105,53.0,78034,18,78139
18,"Crimson Tide Invitational, Sam Bailey Track Stadium, Tuscaloosa, AL",USA,05 APR 2024,06 APR 2024,65,76.0,78054,17,78119
19,"ASA Athletics Grand Prix 2, Bestmed Tuks Stadium, Pretoria",RSA,18 MAR 2024,18 MAR 2024,195,31.0,77884,19,78079
20,"Troféu Adhemar Ferreira da Silva Loterias Caixa de Atletismo, CNDA, Bragança Paulista",BRA,05 APR 2024,07 APR 2024,410,16.0,77626,22,78036
21,"ASA Athletics Grand Prix 1, McArthur Stadium, Potchefstroom",RSA,14 MAR 2024,14 MAR 2024,420,14.0,77488,26,77908
22,"Arizona Spring Break Fiesta, Univ. of Arizona Roy P. Drachman Stadium, Tucson, AZ",USA,16 MAR 2024,16 MAR 2024,140,38.0,77637,21,77777
23,"South Florida Invitational, University of South Florida Track & Field Stadium, Tampa, FL",USA,05 APR 2024,06 APR 2024,185,33.0,77518,25,77703
24,"UCF Black & Gold Invite, UCF Soccer and Track Complex, Orlando, FL",USA,15 MAR 2024,16 MAR 2024,30,103.0,77643,20,77673
25,"Willie Williams Classic, Univ. of Arizona Roy P. Drachman Stadium, Tucson, AZ",USA,22 MAR 2024,23 MAR 2024,80,67.0,77570,23,77650
26,"Clyde Hart Classic, Clyde Hart Track & Field Stadium, Waco, TX",USA,22 MAR 2024,23 MAR 2024,95,59.0,77537,24,77632
27,"International Track Meet, Nga Puna Wai Sports Hub, Christchurch",NZL,24 FEB 2024,24 FEB 2024,730,5.0,76829,31,77559
28,"3rd AK Track And Field Weekend Meeting, Nyayo National Stadium, Nairobi",KEN,26 JAN 2024,27 JAN 2024,310,20.0,77245,27,77555
29,"Sir Graeme Douglas Memorial Track Classic, Douglas Track & Field, Auckland",NZL,10 MAR 2024,10 MAR 2024,560,11.0,76891,30,77451
30,"Keyth Talley Invitational, LSU Bernie Moore Stadium, Baton Rouge, LA",USA,23 MAR 2024,23 MAR 2024,130,44.0,77209,28,77339
31,"Jim Click Shootout & Multis, Univ. of Arizona Roy P. Drachman Stadium, Tucson, AZ",USA,05 APR 2024,06 APR 2024,130,44.0,77071,29,77201
32,"Hurricane Collegiate Invitational, UMiami Cobb Stadium, Coral Gables, FL",USA,23 MAR 2024,23 MAR 2024,265,25.0,76764,33,77029
33,"UCF Knights Invite, UCF Soccer and Track Complex, Orlando, FL",USA,22 MAR 2024,23 MAR 2024,60,79.0,76815,32,76875
34,"UC San Diego Triton Invitational, Triton Stadium, San Diego, CA",USA,05 APR 2024,06 APR 2024,410,16.0,76077,35,76487
35,"2nd AK Track & Field Weekend Meeting/AK Relay Series, Ulinzi Sports Complex, Langata, Nairobi",KEN,05 JAN 2024,06 JAN 2024,105,53.0,76347,34,76452
36,"Cameron Burrell Alumni Invitational, Carl Lewis TF and Soccer Complex, Houston, TX",USA,06 APR 2024,06 APR 2024,305,21.0,75626,36,75931
37,"Aztec Invitational, San Diego State University, San Diego, CA",USA,21 MAR 2024,23 MAR 2024,270,24.0,75472,38,75742
38,"AGN League 3, Pilditch Stadium, Pretoria",RSA,10 FEB 2024,10 FEB 2024,140,38.0,75547,37,75687
39,"Texas A&M Invitational, Cushing Stadium, College Station, TX",USA,23 MAR 2024,23 MAR 2024,80,67.0,75443,39,75523
40,"18th Spring Break Classic, Pista Basilio Rodriguez, Carolina",PUR,14 MAR 2024,16 MAR 2024,195,31.0,75318,40,75513
41,"FSU Relays, Florida State University - Mike Long Track, Tallahassee, FL",USA,21 MAR 2024,22 MAR 2024,85,64.0,75184,42,75269
42,"JAAA CARIFTA Trials, National Stadium, Kingston",JAM,01 MAR 2024,03 MAR 2024,0,,75256,41,75256
43,"Arkansas Spring Invitational, John McDonnell Field, Fayetteville, AR",USA,06 APR 2024,06 APR 2024,120,50.0,75065,44,75185
44,"AGN League 4, Pilditch Stadium, Pretoria",RSA,24 FEB 2024,24 FEB 2024,105,53.0,75064,45,75169
45,"Curro Podium Final, Pilditch Stadium, Pretoria",RSA,17 FEB 2024,17 FEB 2024,165,35.0,74939,47,75104
46,"VertKlasse Meeting, Dick Vert Stadium, High Point, NC",USA,05 APR 2024,06 APR 2024,160,36.0,74928,48,75088
47,"Virginia Showcase, Virginia Beach Sports Center, Virginia Beach, VA",USA,12 JAN 2024,14 JAN 2024,10,133.0,75076,43,75086
48,"Kirk Baptiste Spring Break Invitational, Tom Tellez Track, Houston, TX",USA,14 MAR 2024,14 MAR 2024,75,73.0,75003,46,75078
49,"Masked Rider Open, Terry & Linda Fuller T&F Complex, Lubbock, TX",USA,22 MAR 2024,23 MAR 2024,45,92.0,74891,49,74936
50,"Africa Games National Trials, Stephen Keshi Stadium, Asaba",NGR,17 FEB 2024,19 FEB 2024,0,,74840,50,74840
51,"WT Jo Meaker Classic & Multi, West Texas A&M University Track & Soccer Complex, Canyon, TX",USA,04 APR 2024,05 APR 2024,0,,74775,51,74775
52,"Tennessee Invite, Tom Black Track at LaPorte Stadium, Knoxville, TN",USA,05 APR 2024,06 APR 2024,30,103.0,74692,52,74722
53,"GC Foster Classic, GC Foster College, Spanish Town",JAM,09 MAR 2024,09 MAR 2024,295,23.0,74301,54,74596
54,"The 57th Tokyo Big 6, Keio Univ. Hiyoshi Athletics Field, Yokohama",JPN,06 APR 2024,07 APR 2024,50,84.0,74357,53,74407
55,"Joe Walker Invitational, Ole Miss T&F Complex, Oxford, MS",USA,05 APR 2024,06 APR 2024,125,49.0,74187,55,74312
56,"Bob Davidson Team Challenge presented by Norris Woody, Dick Vert Stadium, High Point, NC",USA,22 MAR 2024,23 MAR 2024,25,109.0,74133,56,74158
57,"Trojan Invite, USC Cromwell Field at Loker Track Stadium, Los Angeles, CA",USA,22 MAR 2024,23 MAR 2024,90,61.0,74054,57,74144
58,"2º Circuito Paulista OPEN, Centro de Atletismo Professor Oswaldo Terra, Sao Bernardo do Campo",BRA,16 MAR 2024,16 MAR 2024,130,44.0,73151,58,73281
59,"Ole Miss Classic, Ole Miss T&F Complex, Oxford, MS",USA,22 MAR 2024,23 MAR 2024,135,43.0,73140,59,73275
60,"AGN League 5, Pilditch Stadium, Pretoria",RSA,02 MAR 2024,02 MAR 2024,50,84.0,73090,60,73140
61,"Continental Tour Semana del Mar, Pista de Atletismo Justo Román, Mar del Plata",ARG,10 APR 2024,10 APR 2024,365,18.0,72637,62,73002
62,"UTSA Invitational, Park West Ath. Complex, San Antonio, TX",USA,15 MAR 2024,16 MAR 2024,20,114.0,72695,61,72715
63,"Western Milo Relays, GC Foster College, Spanish Town",JAM,10 FEB 2024,10 FEB 2024,55,82.0,72574,63,72629
64,"Sri Lanka Athletics Open Stage 1, Mahinda Rajapaksha Stadium, Diyagama",SRI,01 MAR 2024,02 MAR 2024,50,84.0,72499,64,72549
65,"AGN League 2, Pilditch Stadium, Pretoria",RSA,27 JAN 2024,27 JAN 2024,85,64.0,72452,65,72537
66,"Continental Tour Ciudad de Santiago, E.Nacional, Santiago de Chile",CHI,31 MAR 2024,31 MAR 2024,305,21.0,72159,71,72464
67,"Sam Howell Invitational, Weaver Stadium, Princeton, NJ",USA,30 MAR 2024,30 MAR 2024,10,133.0,72420,66,72430
68,"2024 Spring Challenge Meet, National Stadium, Tokyo",JPN,15 MAR 2024,17 MAR 2024,15,118.0,72365,67,72380
69,"Yellow Jacket Invitational, Geroge C. Griffin Track, Atlanta, GA",USA,16 MAR 2024,16 MAR 2024,10,133.0,72340,68,72350
70,"17th Iwakabe Cup, Athletic Park, Ageo",JPN,07 APR 2024,07 APR 2024,45,92.0,72284,69,72329
71,"Encuentro FMAA César Moreno Bravo 2024, Centro Deportivo Olímpico Mexicano, Ciudad de México",MEX,05 APR 2024,07 APR 2024,10,133.0,72271,70,72281
72,"Copa Nuevo León Luciano Ramírez Gallardo, Pista del Centro Deportivo Borregos, Estadio Azul ITESM, Monterrey",MEX,24 FEB 2024,25 FEB 2024,90,61.0,72069,72,72159
73,"New Taipei City Youth Cup National Athletics Opens, Banqiao Stadium, New Taipei City",TPE,04 MAR 2024,08 MAR 2024,35,99.0,71879,74,71914
74,"Beach Opener, Jack Rose Track, Long Beach, CA",USA,01 MAR 2024,02 MAR 2024,55,82.0,71854,75,71909
75,"41th Tokai University-Nihon University Game, Nihon University Athletics Stadium, Setagaya",JPN,07 APR 2024,07 APR 2024,0,,71891,73,71891
76,"Central Hurdles Relays & Field Events, GC Foster College, Spanish Town",JAM,20 JAN 2024,20 JAN 2024,60,79.0,71796,77,71856
77,"Corporate Area Development Meet, National Stadium, Kingston",JAM,16 FEB 2024,17 FEB 2024,0,,71812,76,71812
78,"Mangrum Invitational, Mangrum Track & Field, San Marcos, CA",USA,22 MAR 2024,22 MAR 2024,0,,71706,78,71706
79,"UNLV Rebels Elite, Myron Partridge Stadium & Sheila Tarr-Smith Field, Las Vegas, NV",USA,05 APR 2024,06 APR 2024,100,56.0,71469,80,71569
80,"Oliver Nikoloff Invitational, Gettler Stadium, Cincinnati, OH",USA,29 MAR 2024,30 MAR 2024,50,84.0,71484,79,71534
81,"Grand Prix Atletica Chilena, E.Nacional, Santiago de Chile",CHI,28 MAR 2024,28 MAR 2024,225,27.0,71230,83,71455
82,"Oregon Preview, Hayward Field, Eugene, OR",USA,22 MAR 2024,23 MAR 2024,10,133.0,71425,81,71435
83,"Charles Austin Classic, Bobcat Track and Field Complex, San Marcos, TX",USA,22 MAR 2024,23 MAR 2024,45,92.0,71308,82,71353
84,"USD Early Bird, Mildred J. Hillenbrand Memorial Track, Vermillion, SD",USA,05 APR 2024,06 APR 2024,35,99.0,71190,84,71225
85,"Pre-Africa Games Meet, MKO Abiola National Stadium, Abuja",NGR,02 FEB 2024,03 FEB 2024,0,,71190,84,71190
86,"Velocity Fest 14, National Stadium, Kingston",JAM,16 MAR 2024,16 MAR 2024,620,9.0,70534,96,71154
87,"54th Hokuriku Corporate team Competition, Niigatashi Field, Niigata",JPN,06 APR 2024,07 APR 2024,80,67.0,71041,87,71121
88,"Alan Connie Shamrock Invitational, Doug Shaw Memorial Stadium, Myrtle Beach, SC",USA,14 MAR 2024,16 MAR 2024,0,,71105,86,71105
89,"22nd National Federation Cup U20, SAI Regional Centre Sarojini Nagar, Lucknow",IND,08 MAR 2024,10 MAR 2024,0,,71033,88,71033
90,"Potts Classic, Hawke's Bay Sports Park, Hastings",NZL,20 JAN 2024,20 JAN 2024,160,36.0,70821,91,70981
91,"3º Encontros de Atletismo, COTP Stadium, São Paulo",BRA,02 MAR 2024,02 MAR 2024,50,84.0,70922,89,70972
92,"National University Athletics Opens, Taipei Municipal Stadium, Taipei City",TPE,29 MAR 2024,30 MAR 2024,20,114.0,70883,90,70903
93,"AGN League 1, Pilditch Stadium, Pretoria",RSA,20 JAN 2024,20 JAN 2024,45,92.0,70782,92,70827
94,"The Vince O’Boyle Track and Field Classic, Anteater Stadium, Irvine, CA",USA,29 MAR 2024,29 MAR 2024,0,,70733,93,70733
95,"Colorado Invitational, Potts Field, Boulder, CO",USA,05 APR 2024,05 APR 2024,40,96.0,70669,94,70709
96,"Invitational Track and Field Event, National Stadium, Gaborone",BOT,17 FEB 2024,17 FEB 2024,65,76.0,70569,95,70634
97,"Camperdown Classics, National Stadium, Kingston",JAM,10 FEB 2024,10 FEB 2024,140,38.0,70393,97,70533
98,"Pomona-Pitzer Track & Field Invitational, Strehle Track, Pomona College, Claremont, CA",USA,06 APR 2024,06 APR 2024,40,96.0,70352,98,70392
99,"Queen's/Grace Jackson Track Meet, National Stadium, Kingston",JAM,27 JAN 2024,27 JAN 2024,210,29.0,70180,101,70390
100,"Cathy Freeman Shield, Queensland Sport and Athletics Centre, Nathan, Brisbane",AUS,24 FEB 2024,24 FEB 2024,35,99.0,70345,99,70380
